x,x, , , , ,x,x,
 , , , , , , , ,
 , , , , , , , ,
 , , , , , , , ,
 , , , , , , , ,
 , , , , , , ,o,
