x,x, , , , ,x,x,
 , , , , , , , ,
 , , , , , , , ,
 , , , , , , , ,
 , , , , , , , ,
 , ,o, ,o, , ,o,
