x,x, ,b, , ,x,x,
 , , ,b, , , , ,
 , , ,b,b,b,b,b,
 , , , , , , , ,
 , , , , , , , ,
 , , , , , , ,o,
