m,m,m,m,m,m,m,m,m,m,m,m,m,m,m,m
m,o, , , , , , , , , , , , , ,m
m, , , , , , , , , , , , , , ,m
m, , ,m,m,m,m,m,m,m, , ,m, , ,m,m,m
m, , ,m, , , , , ,m, , ,m, , , , ,m
m, , ,m, , , , , ,m, , ,m, , , , ,m
m, , ,m, , , , , ,m, , ,m, , , , ,m
m, , ,m,m,m,m, , ,m, , ,m,m, , , ,m
m, , , , , ,m, , ,m, , ,m,m, , , ,m
m,m,m, , , ,m, , ,m, , ,m,m,m, , ,m
 , ,m, , , ,m,m,m,m, , ,m,m,m, , ,m 
 , ,m, , , , , , , , , , , , , , ,m
 , ,m, , , , , , , , , , , , , , ,m
m,m,m,m,m,m,m,m,m,m,m,m,m, , , , ,m
m, , , , , , , , , , , , , , , , ,m
m,x, , , , , , , , , , , , , , , ,m
m, , , , , , , , , , , , , , , , ,m
m,m,m,m,m,m,m,m,m,m,m,m,m,m,m,m,m,m

